28 2a 0J 1L 0c 3C 2o 0X
00 2Z 2d 1T 2u 1t 1j 0L
1o 1E 3T 18 3E 1G 27 0L
0v 2t 06 11 1A 2U 4B 1O
2M 3d 2S 0x 0w 0q 0p 2V
18 0q 1D 49 2O 00 1v 2t
1k 3s 3G 21 3w 0W 29 2r
2O 2L 0g 3Y 0M 0u 3i 3C
1r 2c 2q 3o 30 0a 39 1K
